%%%%%%%
% P   %
%o%%% %
% %.  %
% %%% %
%. G  %
%%%%%%%
