%%%%%%%
% P   %
% %%% %
% %.  %
% %%% %
%o.G  %
%%%%%%%
